*** ******
*   *    *
* * * ** *
* *   ** *
**** *** *
*   S*** *
******** T